1111111111111111111
100P0000C000C0C00E1
1111111111111111111
